Mass Effect 2 (2010) Edition: raiz esq dir dir esq esq esq dir SIM
Sid Meier's Civilization®: Beyond Earth™: raiz dir esq dir dir esq dir SIM
ICEY: raiz esq dir esq esq dir esq SIM
The Path: raiz dir dir dir esq esq dir esq SIM
Command & Conquer 3: Kane's Wrath: raiz esq esq esq dir dir esq SIM
Myst III: Exile: raiz esq dir dir esq esq dir dir SIM
The Misadventures of P.B. Winterbottom: raiz dir dir dir esq esq esq dir SIM
Tooth and Tail: raiz dir dir dir esq dir esq esq SIM
Boomerang X: raiz esq esq esq esq dir dir SIM
Frozen Synapse Prime: raiz esq esq dir dir dir dir SIM
BULLET SOUL / バレットソウル - 弾魂 -: raiz esq esq esq esq dir esq esq SIM
Half-Life 2: Episode One: raiz esq dir esq esq esq dir dir SIM
Battle Academy 2: Eastern Front: raiz esq esq esq esq dir esq esq dir NAO
Visage: raiz dir dir dir SIM
The Fall: raiz dir dir dir esq esq esq dir esq NAO
Civilization IV: Beyond the Sword: raiz esq esq esq dir dir esq esq NAO
Wuppo: Definitive Edition: raiz dir dir dir dir dir esq NAO
Age of Wonders Shadow Magic: raiz esq esq esq esq esq dir dir NAO
Star Control III: raiz dir esq dir dir dir dir NAO
Ultros: raiz dir dir dir esq dir dir esq NAO
The Blackwell Legacy: raiz dir dir esq dir dir dir NAO
METAL GEAR SOLID V: THE PHANTOM PAIN: raiz esq dir SIM
Bridge Constructor Portal: raiz esq esq esq esq dir dir dir NAO
Mushroom Wars 2: raiz esq dir dir esq esq dir dir esq NAO
OMORI: raiz esq dir dir esq dir esq dir NAO
Paper Trail: raiz esq dir dir dir dir dir esq NAO
Dominions 3: The Awakening: raiz esq esq dir dir esq esq esq NAO
Pix the Cat: raiz esq dir dir dir dir dir dir NAO
Dark Future: Blood Red States: raiz esq esq dir esq dir dir esq NAO
Valdis Story: Abyssal City: raiz dir dir dir esq dir dir dir NAO
Impostor Factory: raiz esq dir esq dir esq esq NAO
